68888888a00088888887
40000000000000000005
40000000000000000005
40000000000000000005
40000000000000000005
40000000000000000005
40000000000000000005
40000000000000000005
40000000000000000005
40000000000000000005
40000000000000000005
13333333d00033333332
