68888888a00088888887
40000000000000000005
40000000000000000005
40000000000000000005
b000000000000000000c
00000000000000000000
00000000000000000000
00000000000000000000
40000000000000000005
40000000000000000005
40000000000000000005
13333333d00033333332
