68888888888888888887
40000000000000000005
40000000000000000005
40000000000000000005
b0000000000000000005
00000000000000000005
00000000000000000005
00000000000000000005
40000000000000000005
40000000000000000005
40000000000000000005
13333333d00033333332
