68888888a00088888887
40000000000000000005
40000000000000000005
40000000000000000005
4000000000000000000c
40000000000000000000
40000000000000000000
40000000000000000000
40000000000000000005
40000000000000000005
40000000000000000005
13333333333333333332
