68888888a00088888887
40000000000000000005
40000000000000000005
40000000000000000005
b0000000000000000005
00000000000000000005
00000000000000000005
00000000000000000005
40000000000000000005
40000000000000000005
40000000000000000005
13333333333333333332
